-8
12
-8
5
000000000000000000000
000000000000011111110
000000000000011111110
000000000000011111110
000000000000011111110
000000000000011111110
000000000000011111110
000000000000011111110
000000000000000000000
000000000000000000000
000000000000000000000
000000000000000000000
100001000110000000000
000000000110000000000
