-17
22
-10
8
0000000000000000000000000000000000000000
1111111111111111111111111111111111111110
0000000000000000000000000000000000000000
0000000000000000000000000000000000000000
0000000000000000000000111111100000000000
0000000000000000000000111111100000000000
0000000000000000000000111111100000000000
0000000000000000000000111111100000000000
0000000000000000000000111111100000000000
0000000000000000000000111111100000000000
0000000000000000000000111111100000000000
0000000000000000000000000000000000000000
0000000000000000000000000000000000000000
0000000000000000000000000000000000000000
0000000000000000000000000000000000000000
0000000001000010001100000000000000000000
0000000000000000001100000000000000000000
0000000000000000000000000000000000000000
0000000000000000000000000000000000000000
